C 321
F 3824
EA joke on me
NO salut
SO ca va
WE mon chat

1111111111111
11100W0000111
1111111111111
1111111111111
